3D Printing and Additive Manufacturing	3D Print. Addit. Manuf.
Acc. Chem. Res.	Acc. Chem. Res.
ACS Appl Mater Interfaces	ACS Appl. Mater. Interfaces
ACS Appl. Mater. Interfaces	ACS Appl. Mater. Interfaces
Acs Applied Electronic Materials	ACS Appl. Electron. Mater.
ACS Applied Energy Materials	ACS Appl. Energy Mater.
ACS Applied Materials & Interfaces	ACS Appl. Mater. Interfaces
Acs Energy Letters	ACS Energy Lett.
ACS Nano	ACS Nano
ACS Sensors	ACS Sens.
ACS Sustainable Chemistry & Engineering	ACS Sustainable Chem. Eng.
ACTA MEDICA POLONA	Acta Med. Pol.
Adv Funct Mater	Adv. Funct. Mater.
Adv Mater	Adv. Mater.
Adv Sci (Weinh)	Adv. Sci.
Adv. Electron. Mater.	Adv. Electron. Mater.
Advanced Electronic Materials	Adv. Electron. Mater.
Advanced Energy Materials	Adv. Energy Mater.
Advanced Engineering Materials	Adv. Eng. Mater.
ADVANCED FUNCTIONAL MATERIALS	Adv. Funct. Mater.
Advanced healthcare materials	Adv. Healthcare Mater.
Advanced Intelligent Systems	Adv. Intell. Syst.
ADVANCED MATERIALS	Adv. Mater.
Advanced Materials Technologies	Adv. Mater. Technol.
Advanced Science	Adv. Sci.
Advanced Sustainable Systems	Adv. Sustainable Syst.
Angewandte Chemie	Angew. Chem.
Angewandte Chemie (International ed. in English)	Angew. Chem. Int. Ed. Engl.
Annalen der Physik	Ann. Phys.
Apl Materials	APL Mater.
Applied Composite Materials	Appl. Compos. Mater.
Applied Energy	Appl. Energy
Applied Mechanics and Materials	Appl. Mech. Mater.
APPLIED PHYSICS A-MATERIALS SCIENCE & PROCESSING	Appl. Phys. A-Mater. Sci. Process.
Applied Physics Letters	Appl. Phys. Lett.
Applied Sciences	Appl. Sci.
Applied Surface Science	Appl. Surf. Sci.
Batteries & Supercaps	Batteries Supercaps
BIOSENSORS & BIOELECTRONICS	Biosens. Bioelectron.
Biosensors and Bioelectronics	Biosens. Bioelectron.
Bulletin of the World Health Organization	Bull. World Health Organ.
Carbohydrate Polymers	Carbohydr. Polym.
CARBON	Carbon
CHEMELECTROCHEM	ChemElectroChem
Chemical Communications	Chem. Commun.
Chemical Engineering Journal	Chem. Eng. J.
Chemical Physics Letters	Chem. Phys. Lett.
Chemical reviews	Chem. Rev.
CHEMICAL SOCIETY REVIEWS	Chem. Soc. Rev.
Chemistry of Materials	Chem. Mater.
Chinese Journal of Luminescence	Chinese J. Lumin.
Chinese Journal of Polymer Science	Chin. J. Polym. Sci.
Circuit World	Circuit World
Composite Structures	Compos. Struct.
COMPOSITES PART A-APPLIED SCIENCE AND MANUFACTURING	Compos. Pt. A-Appl. Sci. Manuf.
Composites Part B: Engineering	Composites, Part B
Composites Science and Technology	Compos. Sci. Technol.
Composites, Part A: Applied Science and Manufacturing	Compos. Part A Appl. Sci. Manuf.
Electroanalysis	Electroanalysis
Electrochemical and Solid State Letters	Electrochem. Solid State Lett.
Electrochemistry communications	Electrochem. commun.
Electrochimica Acta	Electrochim. Acta
Electronics Letters	Electron. Lett.
ENERGY & ENVIRONMENTAL MATERIALS	Energy Environ. Mater.
Energy & Environmental Science	Energy Environ. Sci.
Energy Storage Materials	Energy Storage Mater.
Energy Technology	Energy Technol.
European Polymer Journal	Eur. Polym. J.
FlatChem	FlatChem
Flexible and Printed Electronics	Flexible Printed Electron.
Frontiers of Optoelectronics	Front. Optoelectron.
Frontiers of Physics	Front. Phys.
IEEE ACCESS	IEEE Access
Ieee Electron Device Letters	IEEE Electron Device Lett.
Ieee Magnetics Letters	IEEE Magn. Lett.
Ieee Sensors Journal	IEEE Sens. J.
IEEE Spectrum	IEEE Spectr.
IEEE TRANSACTIONS ON INFORMATION TECHNOLOGY IN BIOMEDICINE	IEEE Trans. Inf. Technol. Biomed.
Ieee Transactions on Instrumentation and Measurement	IEEE Trans. Instrum. Meas.
Ieee Transactions on Magnetics	IEEE Trans. Magn.
Ieee Transactions on Nanotechnology	IEEE Trans. Nanotechnol.
Ieee Transactions on Robotics	IEEE Trans. Robot.
InfoMat	InfoMat
Integrated Ferroelectrics	Integr. Ferroelectr.
INTERNATIONAL JOURNAL OF ELECTROCHEMICAL SCIENCE	Int. J. Electrochem. Sci.
International Journal of Solids and Structures	Int. J. Solids Struct.
J. Ind. Text.	J. Ind. Text.
J. Mater. Chem. A	J. Mater. Chem. A
Japanese Journal of Applied Physics	Jpn. J. Appl. Phys.
Joule	Joule
Journal of Alloys and Compounds	J. Alloys Compd.
Journal of Applied Physics	J. Appl. Phys.
Journal of Applied Polymer Science	J. Appl. Polym. Sci.
JOURNAL OF COLLOID AND INTERFACE SCIENCE	J. Colloid Interface Sci.
Journal of Computer-Aided Design & Computer Graphics	J. Comput.-Aided Des. Comput. Graph.
Journal of Electromagnetic Waves and Applications	J. Electromagn. Waves Appl.
Journal of Electronic Materials	J. Electron. Mater.
JOURNAL OF ENDOCRINOLOGY	J. Endocrinol.
Journal of Energy Chemistry	J. Energy Chem.
Journal of Functional Materials	J. Funct. Mater.
Journal of Inequalities and Applications	J. Inequal. Appl.
Journal of Information Display	J. Inf. Disp.
Journal of Magnetism and Magnetic Materials	J. Magn. Magn. Mater.
Journal of Manufacturing Systems	J. Manuf. Syst.
Journal of Materials Chemistry	J. Mater. Chem.
Journal of Materials Chemistry A	J. Mater. Chem. A
Journal of Materials Chemistry A: Materials for Energy and Sustainability	J. Mater. Chem. A
Journal of Materials Chemistry B: Materials for Biology and Medicine	J. Mater. Chem. B
Journal of Materials Chemistry C	J. Mater. Chem. C
Journal of Materials Chemistry C: Materials for Optical and Electronic Devices	J. Mater. Chem. C
Journal of Materials Science & Technology	J. Mater. Sci. Technol.
Journal of Materials Science: Materials in Electronics	J. Mater. Sci.: Mater. Electron.
JOURNAL OF MEDICAL ENGINEERING & TECHNOLOGY	J. Med. Eng. Technol.
Journal of Micromechanics and Microengineering	J. Micromech. Microeng.
Journal of Nanoscience and Nanotechnology	J. Nanosci. Nanotechnol.
JOURNAL OF NEUROCHEMISTRY	J. Neurochem.
Journal of Physics D-Applied Physics	J. Phys. D-Appl. Phys.
Journal of Power Sources	J. Power Sources
Journal of South China University of Technology (Natural Science)	J. South China Univ. Technol. (Nat. Sci.)
Journal of Synthetic Crystals	J. Synth. Cryst.
Journal of The Electrochemical Society	J. Electrochem. Soc.
JOURNAL OF THE ROYAL STATISTICAL SOCIETY SERIES C-APPLIED STATISTICS	J. R. Stat. Soc. C
Journal of the Royal Statistical Society: Series C (Applied Statistics)	J. R. Stat. Soc. C
Journal of the Taiwan Institute of Chemical Engineers	J. Taiwan Inst. Chem. Eng.
Journal of Vacuum Science & Technology B	J. Vac. Sci. Technol. B
Langmuir	Langmuir
Macromolecular Materials and Engineering	Macromol. Mater. Eng.
Mater Horiz	Mater. Horiz.
Material Science Research India	Mater. Sci. Res. India
Materials & Design	Mater. Des.
Materials Chemistry and Physics	Mater. Chem. Phys.
MATERIALS HORIZONS	Mater. Horiz.
MATERIALS SCIENCE AND ENGINEERING A-STRUCTURAL MATERIALS PROPERTIES MICROSTRUCTURE AND PROCESSING	Mater. Sci. Eng. A-Struct. Mater. Prop. Microstruct. Process.
Materials Today	Mater. Today
Materials Today Communications	Mater. Today Commun.
Materials Today Physics	Mater. Today Phys.
MATERIALS TODAY-PROCEEDINGS	Mater. Today-Proc.
MEDICAL JOURNAL OF AUSTRALIA	Med. J. Aust.
Micro & Nano Letters	Micro Nano Lett.
Microchemical Journal	Microchem. J.
Microelectronic Engineering	Microelectron. Eng.
Microsystem Technologies	Microsyst. Technol.
Microwave and Optical Technology Letters	Microw. Opt. Technol. Lett.
Nano	Nano
Nano Energy	Nano Energy
NANO LETTERS	Nano Lett.
Nano Research	Nano Res.
Nano Today	Nano Today
Nano-Micro Letters	Nano-Micro Lett.
Nanomaterials	Nanomaterials
Nanomicro Lett	Nano-Micro Lett.
Nanoscale	Nanoscale
Nanotechnology	Nanotechnology
Nat Commun	Nat. Commun.
Nat Mater	Nat. Mater.
Nat Nanotechnol	Nat. Nanotechnol.
Nat. Commun.	Nat. Commun.
Nat. Mater.	Nat. Mater.
Nature	Nature
NATURE COMMUNICATIONS	Nat. Commun.
Nature Electronics	Nat. Electron.
NATURE MATERIALS	Nat. Mater.
NATURE NANOTECHNOLOGY	Nat. Nanotechnol.
New Chemical Materials	New Chem. Mater.
New Journal of Chemistry	New J. Chem.
New Journal of Physics	New J. Phys.
Nihon rinsho. Japanese journal of clinical medicine	Nihon Rinsho
NPG Asia Materials	NPG Asia Mater.
Occupational Health	Occup. Health
ONCOLOGY NURSING FORUM	Oncol. Nurs. Forum
Optics and Lasers in Engineering	Opt. Lasers Eng.
Optoelectronics and Advanced Materials-Rapid Communications	Optoelectron. Adv. Mater.-Rapid Commun.
Organic Electronics	Org. Electron.
Physica Status Solidi-Rapid Research Letters	Phys. Status Solidi-Rapid Res. Lett.
Physical Review E	Phys. Rev. E
Physical Review Letters	Phys. Rev. Lett.
Polymer Reviews	Polym. Rev.
Polymers	Polymers
Polymers (Basel)	Polymers
Proceedings of the Ieee	Proc. IEEE
Proceedings of the National Academy of Sciences of the United States of America	Proc. Natl. Acad. Sci. U.S.A.
Prog. Mater. Sci.	Prog. Mater. Sci.
PROGRESS IN CHEMISTRY	Prog. Chem.
Robotics and Autonomous Systems	Robot. Auton. Syst.
Royal Society Open Science	R. Soc. Open Sci.
RSC Adv.	RSC Adv.
RSC Advances	RSC Adv.
Sci Robot	Sci. Robot.
Sci. Adv.	Sci. Adv.
Science	Science
Science & Technology Review	Sci. Tech. Rev.
Science Advances	Sci. Adv.
SCIENCE CHINA-INFORMATION SCIENCES	Sci. China-Inf. Sci.
Science Robotics	Sci. Robot.
Scientific Reports	Sci. Rep.
SENSORS	Sensors
Sensors (Basel)	Sensors
SENSORS AND ACTUATORS A-PHYSICAL	Sens. Actuators, A
Sensors and Actuators A: Physical	Sens. Actuators, A
SENSORS AND ACTUATORS B-CHEMICAL	Sens. Actuator B-Chem.
Small	Small
Small Methods	Small Methods
Smart Mater. Struct.	Smart Mater. Struct.
Smart Materials and Structures	Smart Mater. Struct.
Solar Energy Materials and Solar Cells	Sol. Energy Mater. Sol. Cells
Solid State Ionics	Solid State Ionics
SURGICAL ENDOSCOPY AND OTHER INTERVENTIONAL TECHNIQUES	Surg. Endosc.
Synthetic Metals	Synth. Met.
Text. Res. J.	Text. Res. J.
The Journal of Physical Chemistry C	J. Phys. Chem. C
Translational Materials Research	Transl. Mater. Res.
Wear	Wear
